CSS Registration Form=CSS Registrierungsformular
Registration=Registrierung
Account Details=Kontodetails
Email=E-Mail
Repeat email=E-Mail wiederholen
Password=Passwort
Repeat Password=Passwort wiederholen
obligatory fields=Pflichtfelder
Personal Details=Persönliche Daten
Name=Name
Phone=Telefon
Street=Strasse
City=Stadt
Country=Land
United States=United States
Website=Webseite
Further Information=Weitere Information
Gender=Geschlecht
Male=Männlich
Female=Weiblich
Birthdate=Geburtsdatum
January=Januar
February=Februar
March=März
April=April
May=Mai
June=Juni
July=Juli
August=August
September=September
October=Oktober
November=November
December=Dezember
Nationality=Nationalität
Helpful Information=Nützliche Informationen
Children=Kinder
Here comes some explaining text, sed ut perspiciatis unde omnis iste natus error sit voluptatem accusantium doloremque laudantium, totam rem aperiam, eaque ipsa quae ab illo inventore veritatis et quasi architecto beatae vitae dicta sunt explicabo.=Hier kommt ein erklärender Text, sed ut perspiciatis unde omnis iste natus error sit voluptatem accusantium doloremque laudantium, totam rem aperiam, Eaque ipsa quae ab illo inventore veritatis et quasi architecto beatae vitae dicta sunt explicabo .
Terms and Mailing=Nutzungsbedingungen und Benachrichtigungen
I accept the=Ich akzeptiere die
Terms and Conditions=AGB
I want to receive personalized offers by your site=Ich möchte persönliche Angebote von Ihrer Webseite erhalten
Allow partners to send me personalized offers and related services=Senden Sie mir personalisierte Angebote und Dienstleistungen von Partnern
Register=Registrieren